111111111111111111111111111111111111111111
1P000000C000C00000000000C00000000000000001
100001010010000010100100000001010000010001
100000101010100010010000000101000100010001
1E000000000000C0000000000000000001C0010001
100000010000000000001000000000000000000001
100C00000001000010000C000000000000C0000001
10000101001000001010010000C001010000000111
100000101010100010011000000101000000000111
1000000C000000100001C0000001000000C0000001
111111111111111111111111111111111111111111