111111111111111111111111111111111111111111111
1P0000000000000000000000000000000000000111111
100000000000000000000000000000000000000111111
100000011111111111111111111000000000000111111
1000000000000000000000000C1000000000000111111
100000000000000000000000001000000000000111111
100000011111111111111000001000000000000111111
1000000000000000000C1000001000000000000111111
100000001111111111111000001000000000000111111
100000001000000000000000001000000000000111111
100000001C00000000000000001000000000000111111
100000001111111111111111111000000000000111111
100000000000000000000000000000000000000111111
100000000000000000000000000000000000000111111
100000000000000000000000000000000000000111111
100000000000000000000000000000000000000111111
100000000000000000000000000000000000000111111
100000000000000000000000000000000000000111111
100000000000000000000000000000000000000111111
10000000000000000000000000000000000000E111111
111111111111111111111111111111111111111111111
111111111111111111111111111111111111111111111
111111111111111111111111111111111111111111111